11111111111111
10010000000001
10000111110001
1C001100000T01
1P00000E00T001
11111111111111